# #####   
###   #   
#x@B  #   
### Bx#   
#x##B #   
# # x ##  
#B OBBx#  
#   x  #  
########  
########  
