##########
#x    B  #
#######  #
#@B     x#
## ####  #
#  BxxB  #
#  B##B  #
#   ##   #
#   xx   #
##########
