##########
#x#x    x#
# ###  ###
#      B #
#  ##  B #
###@   B #
#  #  ## #
#B # B#  #
#x      x#
##########
