##########
#       x#
#        #
#  #OO#  #
#  O@ O  #
#  O  O  #
#  #OO#  #
#    B   #
#        #
##########
